11111111111111111111111111000111
10000000000001100000000000000011
10000000000001110001100000000011
10000000000001110000001111110011
11111111000001110000011111100011
11110000001000111000111110000001
10000000000001110000000000000011
11111110000000110000000011111111
10000000000000000000000000000001
10000000011100000000000000000001
10000000000000000011111111111111
10000000000000000000000001111111
11111100000000000000000000000001
11111111100000000000000000000001
00000000000000011111100000000001
00000000000000111111111111000001
00000000000000000000000000000001
11111111111111111111110000000001
11111111111111111111111111111111