1111111111111111111111111111111111111111111111111111111111111111111111111111111111111111111111111111111
1000000000000000000000000000000000000000000000000000000000000000000000000000000000000000000000000000000
1000000000000000000000000000000000000000000000000000000000000000000000000000000000000000000000000000000
1000000000000000000000000000000000000000000000000000000000000000000000000000000000000000000000000000000
1000000000000000000000000000000000000000000000000000000000000000000000000000000000000000000000000000000
1000000000000000000000000000000000000000000000000000000000000000000000000000000000000000000000000000000
1000000000000000000000000000000000000000000000000000000000000000000000000000000000000000000000000000000
1000000000000000000000000000000000000000000000000000000000000000000000000000000000000000000000000000000
1000000000000000000000000000000000000000000000000000000000000000000000000000000000000000000000000000000
1000000000000000000000000000000000000000000000000000000000000000000000000000000000000000000000000000000
1000000000000000000000000000000000000000000000000000000000000000000000000000000000000000000000000000000
1000000000000000000000000000000000000000000000000000000000000000000000000000000000000000000000000000000
1000000000000000000000000000000000000000000000000000000000000000000000000000000000000000000000000000000
1000000000000000000000000000000000000000000000000000000000000000000000000000000000000000000000000000000
1000000000000000000000000000000000000000000000000000000000000000000000000000000000000000000000000000000
1000000000000000000000000000000000000000000000000000000000000000000000000000000000000000000000000000000
1000000000000000000000000000000000000000000000000000000000000000000000000000000000000000000000000000000
1000000000000000000000000000000000000000000000000000000000000000000000000000000000000000000000000000000
1000000000000000000000000000000000000000000000000000000000000000000000000000000000000000000000000000000
1000000000000000000000000000000000000000000000000000000000000000000000000000000000000000000000000000000
1000000000000000000000000000000000000000000000000000000000000000000000000000000000000000000000000000000
1000000000000000000000000000000000000000000000000000000000000000000000000000000000000000000000000000000
1000000000000000000000000000000000000000000000000000000000000000000000000000000000000000000000000000000
1000000000000111111111111111111111111111111111111111111111111111111111111111111111111111111111111111111
1000000000000100000000000000000000000000000000000000000000000000000000000000000000000000000000000000000
1000000000000100000000000000000000000000000000000000000000000000000000000000000000000000000000000000000
1000000000000100000000000000000000000000000000000000000000000000000000000000000000000000000000000000000
1000000000000100000000000000000000000000000000000000000000000000000000000000000000000000000000000000000
1000000000000100000000000000000000000000000000000000000000000000000000000000000000000000000000000000000
1000000000000100000000000000000000000000000000000000000000000000000000000000000000000000000000000000000
1000000000000100000000000000000000000000000000000000000000000000000000000000000000000000000000000000000
1000000000000100000000000000000000000000000000000000000000000000000000000000000000000000000000000000000
1000000000000100000000000000000000000000000000000000000000000000000000000000000000000000000000000000000
1000000000000100000000000000000000000000000000000000000000000000000000000000000000000000000000000000000
1000000000000100000000000000000000000000000000000000000000000000000000000000000000000000000000000000000
1000000000000100000000000000000000000000000000000000000000000000000000000000000000000000000000000000000
1000000000000100000000000000000000000000000000000000000000000000000000000000000000000000000000000000000
1000000000000100000000000000000000000000000000000000000000000000000000000000000000000000000000000000000
1000000000000100000000000000000000000000000000000000000000000000000000000000000000000000000000000000000
1000000000000100000000000000000000000000000000000000000000000000000000000000000000000000000000000000000
1000000000000100000000000000000000000000000000000000000000000000000000000000000000000000000000000000000
1000000000000100000000000000000000000000000000000000000000000000000000000000000000000000000000000000000
1000000000000100000000000000000000000000000000000000000000000000000000000000000000000000000000000000000
1000000000000100000000000000000000000000000000000000000000000000000000000000000000000000000000000000000
1000000000000100000000000000000000000000000000000000000000000000000000000000000000000000000000000000000
1000000000000100000000000000000000000000000000000000000000000000000000000000000000000000000000000000000
1111111111111100000000000000000000000000000000000000000000000000000000000000000000000000000000000000000
